4 0 0 0 0 4 2 1 1 0 0 5 5 5 5 0
0 4 0 4 0 0 1 1 1 0 5 3 3 3 3 5
4 0 0 0 0 4 2 1 2 0 5 3 3 3 3 5
0 0 4 0 0 0 1 1 1 0 0 5 5 5 5 0
0 4 0 4 0 4 2 1 1 0 0 0 0 0 0 0
0 0 0 0 0 0 1 1 1 2 2 1 2 1 1 2
0 0 4 0 0 4 1 1 2 2 1 2 1 1 2 1
0 0 0 4 0 0 2 1 1 0 0 0 0 0 0 0
0 0 0 0 0 4 1 1 1 0 0 0 0 0 0 0
0 4 0 0 0 0 1 2 1 0 0 0 0 0 0 0
0 0 0 0 0 4 1 1 1 0 0 0 0 0 0 0
0 0 4 0 0 0 2 1 2 0 0 0 0 0 0 0
