0 0 0 0 0 0 0 0 0 0 0 0 0 0 0 0 0 0 0 0 0 0 0 0 0 0 0 0 0 0 0 0 0 0 0 0 0 0 0 0 0 0 0 0 0 0 0 0 0 0
0 0 0 0 0 0 0 0 0 0 0 0 0 0 0 0 0 0 0 0 0 0 0 0 0 0 0 0 0 0 0 0 0 0 0 0 0 0 0 0 0 0 0 0 0 0 0 0 0 0
0 0 0 0 0 0 0 0 0 0 0 0 0 0 0 0 0 0 0 0 0 0 0 0 0 0 0 0 0 0 0 0 0 0 0 0 0 0 0 0 0 0 0 0 0 0 0 0 0 0
0 0 0 0 0 0 0 0 0 0 0 0 0 0 0 0 0 0 0 0 0 0 0 0 0 0 0 0 0 0 0 0 0 0 0 0 0 0 0 0 0 0 0 0 0 0 0 0 0 0
0 0 0 0 0 0 0 0 0 0 0 0 0 0 0 0 0 0 0 0 0 0 0 0 0 0 0 0 0 0 0 0 0 0 0 0 0 0 0 0 0 0 0 0 0 0 0 0 0 0
0 0 0 0 0 0 0 0 0 0 0 0 0 0 0 0 0 0 0 0 0 0 0 0 0 0 0 0 0 0 0 0 0 0 0 0 0 0 0 0 0 0 0 0 0 0 0 0 0 0
0 0 0 0 0 0 0 0 0 0 0 0 0 0 0 0 0 0 0 0 0 0 0 0 0 0 0 0 0 0 0 0 0 0 0 0 0 0 0 0 0 0 0 0 0 0 0 0 0 0
0 0 0 0 0 0 0 0 0 0 0 0 0 0 0 0 0 0 0 0 0 0 0 0 0 0 0 0 0 0 0 0 0 0 0 0 0 0 0 0 0 0 0 0 0 0 0 0 0 0
0 0 0 0 0 0 0 0 0 0 0 0 0 0 0 0 0 6 3 3 3 3 6 4 0 0 3 3 2 2 2 2 3 3 3 3 6 0 0 0 0 0 0 0 0 0 0 0 0 0
0 0 0 0 0 0 0 0 0 0 0 0 0 0 0 6 3 0 6 3 6 3 3 0 0 0 3 2 5 5 5 5 2 3 3 6 0 6 0 0 0 0 0 0 0 0 6 0 0 0
0 0 0 0 0 0 0 0 0 0 0 0 0 0 6 0 3 6 3 3 3 3 6 4 0 4 3 2 5 5 5 5 2 3 3 6 0 6 0 0 0 0 0 0 0 6 0 4 0 0
0 0 0 0 0 0 0 0 0 0 0 0 0 6 0 0 3 6 3 6 3 6 4 0 0 3 3 2 2 2 2 3 3 3 0 0 6 0 0 0 0 0 0 0 0 0 6 0 0 0
0 0 0 0 0 0 0 0 0 0 0 0 6 0 0 3 3 3 3 3 3 3 0 0 0 4 4 0 4 0 0 4 3 3 3 0 0 6 0 0 0 0 0 0 0 0 0 6 0 0
0 0 0 0 0 0 0 0 0 0 0 6 0 0 3 3 6 3 3 6 0 0 4 4 0 4 0 0 4 0 3 3 3 3 0 0 0 6 0 0 0 0 0 0 0 0 0 0 0 0
0 0 0 0 0 0 0 0 0 0 6 0 0 3 3 3 6 3 3 6 0 0 3 3 3 3 3 3 3 3 3 3 0 3 3 0 0 6 0 0 0 0 0 0 0 0 0 0 0 0
0 0 0 0 0 0 0 0 0 6 0 0 3 3 3 3 6 3 3 3 3 0 4 0 3 3 3 3 3 3 3 3 0 3 3 0 6 0 0 0 0 0 0 0 0 0 0 0 0 0
0 0 0 0 0 0 0 0 6 0 0 3 3 3 3 3 3 6 3 3 3 4 0 4 3 3 3 3 3 3 3 0 3 3 3 0 0 0 6 0 0 0 0 0 0 0 0 0 0 0
0 0 0 0 0 0 0 6 0 0 3 3 3 3 3 3 3 3 6 0 0 0 3 3 3 3 3 3 3 3 0 0 0 3 3 3 0 0 0 6 0 0 0 0 0 0 0 0 0 0
0 0 0 0 0 0 6 0 0 3 3 3 3 3 3 3 0 0 6 0 0 3 3 3 3 3 3 3 3 0 0 6 0 0 3 3 3 0 0 0 6 0 0 0 0 0 0 0 0 0
0 0 0 0 0 6 0 0 3 3 3 3 3 3 3 0 0 0 0 6 0 3 3 3 3 3 3 3 0 0 0 0 6 0 0 3 3 3 0 0 0 6 0 0 0 0 0 0 0 0
0 0 0 0 6 0 0 3 3 3 3 3 3 0 0 0 3 6 0 0 3 3 3 3 3 3 3 0 0 0 3 6 0 0 3 3 3 0 0 0 0 6 0 0 0 0 0 0 0 0
0 0 0 6 0 0 3 3 3 3 3 0 0 0 0 3 3 0 6 0 3 3 3 3 3 0 0 0 3 3 0 6 0 3 3 3 0 0 0 0 0 0 6 0 0 0 0 0 0 0
0 0 6 0 0 3 3 3 3 0 0 0 0 0 3 3 0 0 0 6 0 0 0 3 3 3 0 0 3 3 0 0 0 6 0 0 0 3 3 3 0 0 0 0 6 0 0 0 0 0
0 6 0 0 3 3 3 0 0 0 0 0 0 3 3 0 0 3 3 0 0 6 0 4 0 3 3 3 0 0 3 3 0 0 6 0 0 3 3 0 0 0 0 0 0 6 0 0 0 0
6 0 0 3 3 0 0 0 0 0 0 3 3 0 0 0 3 0 0 0 0 0 6 0 0 0 3 3 3 0 0 0 3 0 0 0 0 3 0 0 0 0 0 0 0 0 6 0 0 0
0 0 3 0 0 0 0 0 0 3 3 0 0 0 0 3 0 0 0 0 0 0 0 6 0 0 0 3 3 3 0 0 0 6 0 0 0 0 0 0 0 0 0 0 0 0 0 6 0 0
0 3 0 0 0 0 0 3 3 0 0 0 0 0 3 0 0 6 0 0 0 0 0 0 6 0 0 0 3 3 3 0 0 0 6 0 0 0 0 0 6 0 0 0 0 0 0 0 0 6
3 0 0 0 0 3 3 0 0 0 0 0 0 3 0 0 0 0 6 0 0 0 0 0 0 6 0 0 0 3 3 3 6 0 0 0 0 0 6 0 0 0 0 0 0 0 0 0 6 0
0 0 0 3 3 0 0 0 0 0 0 3 0 0 0 0 0 6 0 0 0 0 0 0 0 0 6 0 0 0 6 0 0 0 0 0 0 6 0 0 0 0 0 0 0 0 0 6 0 0